10 10
0 0 
0 108 108 108 108 108 108 108 108 0
111 10 10 10 0 0 10 10 10 110
111 10 10 10 0 0 10 10 10 110
111 10 10 10 0 0 10 10 10 110
111 10 10 10 0 0 10 10 10 110
111 10 10 10 0 0 10 10 10 110
111 10 10 10 0 0 10 10 10 110
111 10 10 10 0 0 10 10 10 110
111 10 10 10 0 0 10 10 10 110
0 109 109 109 109 109 109 109 109 0